{
  "owners": {
    "1": [],
    "2": [],
    "3": [],
    "4": [],
    "5": [],
    "6": [],
    "7": [],
    "8": [],
    "9": [],
    "10": [],
    "11": [],
    "13": [],
    "14": [],
    "15": [],
    "16": [],
    "17": [],
    "19": [],
    "20": [],
    "21": [],
    "23": [],
    "26": [],
    "27": [],
    "30": [],
    "31": [],
    "32": [],
    "33": [],
    "34": [],
    "36": [],
    "37": [],
    "39": [],
    "40": [],
    "42": [],
    "43": [],
    "45": [],
    "46": [],
    "48": [],
    "49": [],
    "51": [],
    "52": [],
    "54": [],
    "55": [],
    "56": [],
    "58": [],
    "59": [],
    "60": [],
    "61": [],
    "62": [],
    "64": [],
    "65": [],
    "66": [],
    "68": [],
    "69": [],
    "70": [],
    "71": [],
    "72": [],
    "73": [],
    "75": [],
    "76": [],
    "77": [],
    "78": [],
    "79": [],
    "80": [],
    "81": [],
    "82": [],
    "83": [],
    "84": [],
    "85": [],
    "86": [],
    "87": [],
    "88": [],
    "89": [],
    "91": [],
    "92": [],
    "93": [],
    "94": [],
    "95": [],
    "97": [],
    "98": [],
    "99": [],
    "100": [],
    "101": [],
    "103": [],
    "104": [],
    "105": [],
    "106": [],
    "107": [],
    "109": [],
    "110": [],
    "111": [],
    "112": [],
    "115": [],
    "116": [],
    "117": [],
    "118": [],
    "119": [],
    "120": [],
    "121": [],
    "122": [],
    "123": [],
    "126": [],
    "127": [],
    "128": [],
    "129": [],
    "130": [],
    "131": [],
    "132": [],
    "133": [],
    "134": [],
    "135": [],
    "136": [],
    "137": [],
    "138": [],
    "139": [],
    "140": [],
    "141": [],
    "142": [],
    "143": [],
    "144": [],
    "145": [],
    "146": [],
    "147": [],
    "148": [],
    "149": [],
    "152": [],
    "153": [],
    "154": [],
    "155": [],
    "156": [],
    "157": [],
    "158": [],
    "159": [],
    "160": [],
    "161": [],
    "163": [],
    "164": [],
    "165": [],
    "166": [],
    "167": [],
    "168": [],
    "169": [],
    "172": [],
    "173": [],
    "174": [],
    "175": [],
    "176": [],
    "177": [],
    "178": [],
    "179": [],
    "180": [],
    "181": [],
    "183": [],
    "185": [],
    "186": [],
    "187": [],
    "188": [],
    "189": [],
    "190": [],
    "191": [],
    "192": [],
    "195": [],
    "196": [],
    "197": [],
    "198": [],
    "199": [],
    "200": [],
    "201": [],
    "202": [],
    "205": [],
    "206": [],
    "207": [],
    "209": [],
    "210": [],
    "211": [],
    "212": [],
    "213": [],
    "215": [],
    "216": [],
    "218": [],
    "219": [],
    "220": [],
    "221": [],
    "222": [],
    "223": [],
    "224": [],
    "226": [],
    "227": [],
    "230": [],
    "231": [],
    "232": [],
    "233": [],
    "234": [],
    "235": [],
    "236": [],
    "237": [],
    "238": [],
    "239": [],
    "240": [],
    "241": [],
    "242": [],
    "243": [],
    "244": [],
    "245": [],
    "246": [],
    "249": [],
    "250": [],
    "251": [],
    "252": [],
    "253": [],
    "254": [],
    "255": [],
    "256": [],
    "257": [],
    "258": [],
    "259": [],
    "260": [],
    "261": [],
    "264": [],
    "265": [],
    "267": [],
    "268": [],
    "269": [],
    "270": [],
    "271": [],
    "273": [],
    "274": [],
    "275": [],
    "276": [],
    "277": [],
    "278": [],
    "279": [],
    "281": [],
    "282": [],
    "283": [],
    "284": [],
    "285": [],
    "286": [],
    "287": [],
    "289": [],
    "290": [],
    "291": [],
    "292": [],
    "293": [],
    "294": [],
    "295": [],
    "297": [],
    "300": [],
    "301": [],
    "302": [],
    "303": [],
    "304": [],
    "305": [],
    "306": [],
    "307": [],
    "310": [],
    "311": [],
    "312": [],
    "313": [],
    "314": [],
    "315": [],
    "316": [],
    "319": [],
    "320": [],
    "321": [],
    "323": [],
    "324": [],
    "326": [],
    "327": [],
    "328": [],
    "329": [],
    "330": [],
    "331": [],
    "333": [],
    "334": [],
    "335": [],
    "336": [],
    "337": [],
    "338": [],
    "339": [],
    "341": [],
    "342": [],
    "343": [],
    "344": [],
    "346": [],
    "349": [],
    "350": [],
    "351": [],
    "353": [],
    "354": [],
    "355": [],
    "356": [],
    "357": [],
    "358": [],
    "359": [],
    "361": [],
    "362": [],
    "363": [],
    "364": [],
    "365": [],
    "367": [],
    "368": [],
    "369": [],
    "371": [],
    "372": [],
    "374": [],
    "375": [],
    "378": [],
    "379": [],
    "381": [],
    "382": [],
    "384": [],
    "385": [],
    "386": [],
    "387": [],
    "388": [],
    "389": [],
    "391": [],
    "392": [],
    "394": [],
    "395": [],
    "397": [],
    "398": [],
    "400": [],
    "401": [],
    "402": [],
    "403": [],
    "404": [],
    "405": [],
    "406": [],
    "408": [],
    "410": [],
    "411": [],
    "412": [],
    "413": [],
    "414": [],
    "416": [],
    "417": [],
    "418": [],
    "419": [],
    "420": [],
    "421": [],
    "422": [],
    "423": [],
    "425": [],
    "426": [],
    "427": [],
    "428": [],
    "429": [],
    "430": [],
    "431": [],
    "432": [],
    "433": [],
    "434": [],
    "435": [],
    "436": [],
    "438": [],
    "440": [],
    "441": [],
    "442": [],
    "443": [],
    "444": [],
    "445": [],
    "446": [],
    "449": [],
    "450": [],
    "451": [],
    "452": [],
    "453": [],
    "454": [],
    "455": [],
    "457": [],
    "458": [],
    "459": [],
    "460": [],
    "461": [],
    "462": [],
    "463": [],
    "464": [],
    "466": [],
    "469": [],
    "470": [],
    "471": [],
    "472": [],
    "473": [],
    "474": [],
    "475": [],
    "476": [],
    "479": [],
    "480": []
  },
  "ambiguous": {}
}